Laudabrigpa-balkr.

i Capi tuli: oi laudabrigpi.

II Capituli: oi laudalaup.

lll Capituli: of nterkiagisngm

lt* Capituli: oi lysitarvbrzlo.

l' Capituli: at geta lyritz.

ll Capituli: ol' beiting.

tlt Capituli: ol rauuarstelaur.

l'lii Capituli: of ovaeruteigu.

tx Capituli: of fiarrextr oc misgiiugot·
liar.

K Capituli: ui altrrextra liar.

tt Capituli: ot suin oc aningnr.

ΧΠ Capituli: oi rep oc oi mala a laudi
oca bprom gripum.

xttl Capituli: ol brec.

xlv Capituli: 'of landescipti.

XV Capituli: ol garplatg. ’

XYi Capituli: oi bruargirrp ou ieriohald.

itit Capituli: ol engitlom.

mu Capituli: of heyrela.

m Capituli: um settara.

U Capituli: ei mapa cypit· land titt.

m Capituli: eu oi sellarr.

Scorto lxi.

Defundis relaeadis, elocandIs et
rebus rusticis.

Titulus I: dc relaitione fundorum.

II: cle 'emtione-venditionesuraiorum.

III .· definiam regundorum circumitionibus.
IV.- de inhibitione per interdictum.

V: cle interdictis servandis.

VI .· depastura.

V II .· dc citationibus ad fines rogandos.
VIII: detractibus inquietis.

IX: de pecoribus actis ct erroneis.

X: de pecoribus retroactis.

XI: de subus et stationibus.

XII: cle pignore et jure protimiseos tant iu
fundis, qvam aliis rebus.

. XIII: de licitatione dolosa.

XIV: defundis dividundis.

XV: dc sepe exstruenda.

XVI: de ponte saciando etqmba babendu-
XVII .· de judicio pratensi.

XVIII: clesoeno cusu congesto.

XIX .· de oestivr's petendis.
XX: si qvis fundum suum incultum jacea:

acit.
xxti adboec de aestiris petendis.

 

