-201-

XLIII Capituli: oi aueltiqvi rip airett.
XLIV Capituli: of garplag rip afrett.

XLV Capituli: ol luigo lond.

XLVI Capituli: ol aoiptiugar elio νῖψ-
ingar buu.

XLVII Capituli: oi vespa: oc almanu-
ingar. '

XLVIII Capituli: um fugladrap.

XLIX Capituli: um veipar i viituom.

L Capituli: el a breytir farvegi sinum.

Ll Capituli: ef mapr fipr grip anuara
mauuz.

Lll Capituli: Relapattr.

Llll Capituli: um aspar llutning.

LIV Capituli: ei mapa· laupir reka oi
laudi manna.

LV Capituli: um hvalreka:

Ll'l Capituli: um hvatreta a leigoluudi.

ml Capituli: el aunurr mapa· a lond
eon fiitro.

Ll'lll Capituli: um samuelo.
ΠΧ Capituli: un) hualarir oc aootmauua
lut· ³

lXCapituli:

Lxl Capituli: um scot.

an Capituli: um scotmauualut.

XLlll Capituli: um tarpaeizlo acotfiar.

mv Capituli: um virping a laval.

le' CapitulI:

tttv1 Capituli: um heimtiog scotliar.
II.

XLIII: de claustris famelicis, od pascua
communia extruendis.

XLIV: de sepe od pascua communia ex·
structa.

XLV: defundis locutis-conductis.

XLVI : de accolis od divr'dendum rel oesti- . ⁷
mundum denominatis. '

XLVII: de venatione an genere) et locis ·
venandi communibus.

XLVIII: de oncupio avit olienoe·

XLIX: de piscatione.

L: si omnis alveum derelinquerit.

LI: si qais rern alienum invenerit.

LII: Sectio de eiectamentist

LIII: de materiei rectura.

LIV: ai qvis jus litoris in sunda alieno
emerit.

LV: de balent: ejectitiis. ,

LVI: de balent: in fundum locatum-'con
:luctum ejectis.

LVII: si uni fundus, alteri jus litoris,
suerit.

LVIII: dejure litoris communi.

LIX: :le jocalia cetariis et portione jaon·
lontio.

LX:

LXI : cle joculatione· ’

LXII: de portione jaculantis.

LXIII: de jaculi portione custodienda.

LXIV: de boleno estimanda.

LXV:

LXVI: de jaculi portione enae‘gando.
C o

 

